111111111
10000C0E1
1000000P1
111111111


